11111111111111111111111111
10010000000C11000011111001
1P0011E0000011111111111111
100100000000000000000C1101
1P0011E0000000000000000001
10010000000C11000011111001
1P0011E0000011111111111111
10010000000C11000011111001
11111111111111111111111111